R 300 300

NO ./statics/texture/blue.xpm

SO ./statics/texture/Slime.xpm

WE ./statics/texture/Red10.xpm

EA ./statics/texture/eagle.xpm

S        ./statics/texture/barrel.xpm

F 187,210,225
C 37,253,233
F 12,33,11




        1111111111111111111111111
        1100000000110000001000001
        1010000011100000010000011
        1001000000000000000000001
111111111111000001110000000000001
100000000011000001110100111111111
10000000000000000000000000001
10000000000000000000000000001
10000001100000222200011000001
10000001100000000000110000001
10000000000000200000000000001
10000000000000000000000000001
10000000000000000000000000001
11110111110111011100000010001
11110111110111011101010010001
11000000110101011100020010001
100010000000000000000200N0001
10000000000000000001010002001
110000011101010111110111100111
11110111 1110101 101111010001
11111111 1111111 111111111111
